..........
...B#.....
...##.....
..........
...####...
.##.......
..#######.
..........
......A...
..........